11111
10001
10011
11001
100C1
10001
10P11
1EC01
100C1
11111