11111111111111111111
1010P1110011C0000111
1EC000C0100100101001
1C000000001000101101
11010001C0C10C000101
101000CC00101110C011
10101000C00010110111
10001100110C10000011
10001101110000110011
10010C0000000100C101
1011000010110C011101
10001C01000100110101
11C00010000010001111
1100000C00001C111111
10000000100000000011
110000C00C0111110011
1C100110100000100101
100000010000C0C10C11
11010001010000010011
101011000000000101C1
11100001010100000001
1110C000000010000101
110C000000C00010C111
100001C1000000000001
10001000110001000001
100C01110001CC010001
10001100011000000011
100000C0100000C11101
1100010000C000100101
11111111111111111111