1111111111111111
1000010000000001
100P010000000001
1000010000000001
100C01E000000001
1111111111111111